NO ./img/colorstone.xpm
EA ./img/greystone.xpm
WE ./img/mossy.xpm
SO ./img/bluestone.xpm

F 0,64,0
C 0,204,255



        1111111111111111111111111
        1S00000000110000000000001
        1011000001110000000000001
        1001000000000000000000001
111111111011000000000000000000001
100000000011000001110111110111111
11110111111111011000000010001
11110111111111011001010010001
11000000110101011000000010001
10000000000000001001010010001
10000000000000001000000010001
110000011101010111110111110011
11000011 1010101 100000000001
11111111 1111111 111111111111

